..................................................
..................................................
..................................................
..................................................
..................................................
..................................................
..................................................
..................................................
..................................................
..................................................
..........#########E#####################.........
..........#.....#...................#...#.........
..........#####.#.#####.###########.#.#.#.........
..........#...#.#.#...#.#.......#...#.#.#.........
..........#.#.#.#.#.#.#.#.#####.#.###.#.#.........
..........#H#.#.#.#.#...#...#.#...#...#.#.........
..........###.#.###.#######.#.#####.###.#.........
..........#...#.....#...#.#...#.....#.#.#.........
..........#.#########.#.#.###.###.###.#.#.........
..........#...........#.....#.#...#...#.#.........
..........#.#####.###########.#.###.#.#.#.........
..........#.#...#...........#...#...#...#.........
..........#.###.###########.#####.#######.........
..........#.........#...#.....#...#.....#.........
..........#########.###.#.###.#.#####.#.#.........
..........#.......#.....#...#.#.#...#.#.#.........
..........#.#####.#####.###.#.#.#.#.###.#.........
..........E.....#.#.......#.#.#...#.#...#.........
..........#####.###.#######.#.#####.#.#.#.........
..........#.....#...#...#...#.....#...#.#.........
..........#.###.#.###.#.#.#####.#######.#.........
..........#.#...#.#...#.#.#...#.#.....#.#.........
..........#.#####.#.#####.#.#.#.#.###.#.#.........
..........#.......#.#.....#.#.#.#.#...#.#.........
..........#.#######.#.#####.#.#.#.#.###.#.........
..........#.#.......#...#...#.#.#.#.....#.........
..........#.###.###.###.#####.#.#.#######.........
..........#.#...#.#.#.#.....#...#.......#.........
..........#.#.###.#.#.###.#.#####.###.#.#.........
..........#...#...........#...........#.#.........
..........#############################E#.........
..................................................
..................................................
..................................................
..................................................
..................................................
..................................................
..................................................
..................................................
..................................................
..................................................