########C######################
#.....#...................#...#
#####.#.#####.###########.#.#.#
#...#.#.#...#.#.......#...#.#.#
#.#.#.#.#.#.#.#.#####.#.###.#.#
#H#.#.#.#.#...#...#.#...#...#.#
###.#.###.#######.#.#####.###.#
#...#.....#...#.#...#.....#.#.#
#.#########.#.#.###.###.###.#.#
#...........#.....#.#...#...#.#
#.#####.###########.#.###.#.#.#
#.#...#...........#...#...#...#
#.###.###########.#####.#######
#.........#...#.....#...#.....#
#########.###.#.###.#.#####.#.#
#.......#.....#...#.#.#...#.#.#
#.#####.#####.###.#.#.#.#.###.#
B.....#.#.......#.#.#...#.#...#
#####.###.#######.#.#####.#.#.#
#.....#...#...#...#.....#...#.#
#.###.#.###.#.#.#####.#######.#
#.#...#.#...#.#.#...#.#.....#.#
#.#####.#.#####.#.#.#.#.###.#.#
#.......#.#.....#.#.#.#.#...#.#
#.#######.#.#####.#.#.#.#.###.#
#.#.......#...#...#.#.#.#.....#
#.###.###.###.#####.#.#.#######
#.#...#.#.#.#.....#...#.......#
#.#.###.#.#.###.#.#####.###.#.#
#...#...........#...........#.#
#############################A#