##########E####################
#.....#...................#...#
#####.#.#####.###########.#.#.#
#...#.#.#...#.#.......#...#.#.#
#.#.#.#.#.#.#.#.#####.#.###.#.#
#.#.#.#.#.#...#...#.#...#...#.#
###.#.###.#######.#.#####.###.#
#...#.....#...#.#...#.....#.#.#
#.#########.#.#.###.###.###.#.#
#...........#.....#.#...#...#.#
#.#####.###########.#.###.#.#.#
#.#...#...........#...#...#...#
#.###.###########.#####.#######
#.........#...#.....#...#.....#
#########.###.#.###.#.#####.#.#
#.......#.....#H..#.#.#...#.#.#
#.#####.#####.###.#.#.#.#.###.#
E.....#.#.......#.#.#...#.#...#
#####.###.#######.#.#####.#.#.#
#.....#...#...#...#.....#...#.#
#.###.#.###.#.#.#####.#######.#
#.#...#.#...#.#.#...#.#.....#.#
#.#####.#.#####.#.#.#.#.###.#.#
#.......#.#.....#.#.#.#.#...#.#
#.#######.#.#####.#.#.#.#.###.#
#.#.......#...#...#.#.#.#.....#
#.###.###.###.#####.#.#.#######
#.#...#.#.#.#.....#...#.......#
#.#.###.#.#.###.#.#####.###.#.#
#...#...........#...........#.#
#############################E#